g g q w w w q w w w w w w w q w w w w w q
g g q g g g q g g g g g g g q g g g g g q
q g q w q g q g q w w w q g q g q w q g q
q g g g g g q g g g g g q g g g q g q g q
q g q g q w q g q g q w q w q w q g q g q
q g q g g g q g q g g g q g q g q g q g q
q w q g q w q w q w q g q g q g q g q g q
q g g g g g g g q g g g q g g g g g g g q
q w q g q w q g q g q w q g q g q w q w q
q g g g q g q g q g q g g g q g g g g g q
q g q w q g q w q g q w q g q w q w q g q
q g g g g g q g q g q g g g q g g g q g q
q g q w q g q g q g q w q g q w q g q g q
q g g g q g q g g g q g g g g g g g q g q
q w w w q g q g q w q g q w q g q g q w q
q g g g g g g g g g q g g g q g q g q t q
q g q g q w q w q g q w q w q w q g q g q
q g q g g g q g q g g g q g g g g g g g q
q g q w q g q g q w q g q w q w w w q g q
q g g g q g g g g g q g g g q g g g g g q
q w w w q w w w w w q w w w q w w w w w q